
Board Stackup
-------------

spin3-rev1-out.art   	Board outline file.

spin3-rev1-crt.art     	Component ref (silkscreen) TOP layer.

spin3-rev1-smt.art 	Solder mask TOP layer.

spin3-rev1-l01.art  	Board TOP / Tracking layer.
spin3-rev1-l02.art  	Layer 2 / VSS plane.
spin3-rev1-l03.art  	Layer 3 / 1V2 plane.
spin3-rev1-l04.art  	Layer 4 / 1V8 plane.
spin3-rev1-l05.art  	Layer 5 / Internal tracking layer.
spin3-rev1-l06.art  	Board BOTTOM / Tracking layer.

spin3-rev1-crb.art     	Silkscreen BOTTOM layer.

spin3-rev1-smb.art  	Solder mask BOTTOM layer.


Drilling / Routing
------------------

spin3-rev1-drl.tap    	Excellon format drill file.
spin3-rev1-rtr.tap  	Excellon format router file.


Board Assembly
--------------

spin3-rev1-spb.art     	Solder paste mask BOTTOM layer.
spin3-rev1-spt.art     	Solder paste mask TOP layer.

spin3-rev1-pcr.csv	Placed component report file.
spin3-rev1-bom.xls	Bill Of Materials file.
